00000p00000pp000
0000000p0e0000p0
0000pppp0ptp00p0
000000000ppp0pp0
00000pp000000p00
00000ce0ppp0pe0p
0000ppp00p00pf00
000000000pp0pppp
00000ppp00p00000
0000000e0pppp0p0
00000ppp0p00emp0
0000d0000000p000

