00000000p0p0ppp0
00000pp000p00000
000000pppe00ppp0
00000p00000pppp0
0000000ppp0pp0pt
0000p000ep0000ep
0000p0p0pp0ppppp
0000p000p00p000p
0000m00pp0pp0p00
0000p0epf00p0e0p
0000p000pppp0p0c
0000ppp000000ppp

