00000000p0000000
0000p0p000ppe000
0000000000pc0000
000000pe00pppppp
00000pppp0p0000p
00000e0tp0pp000p
00000p00p00efp0p
00000000p00ppp0p
00000pppp0000000
00000pm00pppp0pp
00000ppp0ep0000p
000000000000000p